"Eu não estou só", Além do Véu | Música Gospel - YouTube
AUTOR DA MINHA FÉ - Abda Music Coral e Orquestra - YouTube
Acende o fogo (Set a fire + Espontâneo) • DROPS - YouTube
Adoração Central - Digno de Tudo / Te Exaltamos (Ao Vivo) | BRAVE - YouTube
Adoração Central - Inesquecível (Vídeo Ao Vivo) - YouTube
Aleluia de Handel - Coral e Orquestra ADNIPO - YouTube
Alessandra Samadello - Restaura em Mim - YouTube
Alive (Lyric Video) - Hillsong Young & Free - YouTube
Alívio | Amanda Loyola ( COVER ) Live Session ( Jessé Aguiar ) - YouTube
Amo o Senhor - Emerson Pinheiro - YouTube
Ana Clara Acústico - Deus Está Aqui - YouTube
Ao Único Que é Digno de Receber - Igreja Batista da Lagoinha (letra e música) - YouTube
Autor da vida | Kamila Ribeiro - YouTube
Aviva-nos - DEEP Worship (Cantado/Legendado) - YouTube
Aviva-nos/ A Terra Clama - Davi Fernandes & Cultura do Céu (DVD Céu e Terra se Encontram - Ao Vivo) - YouTube
Banda Kadoshi - Compromisso (Lyric) - YouTube
Banda Resgate & Renascer Praise -Leve e Momentânea. - YouTube
Bendito Serás - Toque no Altar. - YouTube
Bruna Karla feat. Gabriela Rocha - Deus da Graça (Ao Vivo) - YouTube
Bruna Olly - Em Ti Jesus "In Jesus' Name" [ LIVE SESSION ] - YouTube
CHAVE | THEO RUBIA (Vídeo Oficial) - Ao Vivo - YouTube
Cadeias Quebrar / As Trevas Estremecem - YouTube
Canção de Amor - A Canção - Davi Silva - YouTube
Canção e Louvor - Live 360º - Ainda Estás Aqui (Video Oficial) - YouTube
Cia. SALT - Quero Conhecer Jesus (Cover Alessandro Villas Boas) - YouTube
Cia. SALT - Quero Conhecer Jesus (Cover Alessandro Villas Boas) | LETRA - YouTube
Coral Voice Soul - Ele Voltará (Ao Vivo) - YouTube
Coral Ébano - Aclame ao Senhor - Darlene Zschech - YouTube
Coroa || SDM Feat Maaty Monteiro - YouTube
Creio que Tu és a cura - Luciano Claw -  CD / DVD Por amor a ti - YouTube
DESPERTA - Andre Valadao - Awake My Soul - YouTube
DEUS DOS deuses LAURIETE COM LETRA(CD TÔ NA MÃO DE DEUS)! - YouTube
Daniel Souza   Jesus É O Rei Da Glória - YouTube
Desperta - O Cordeiro, o Leão e o Trono Parte 1 | Colo de Deus (Clipe Oficial) - YouTube
Deus Proverá - Jairo Bonfim feat. Jeyzer Maia #TamuJuntoPraAdorar - YouTube
Deus dos deuses - Lauriete (Trio Zion) - YouTube
Discopraise - Se Eu Me Humilhar (Vídeo Ao Vivo) - YouTube
E EU VOU - Ministério Filhos da Honra - CD Por amor a mim - YouTube
ENSINA-ME AMAR - Abda Music Coral e Orquestra - YouTube
EU EM SEU LUGAR | COLO DE DEUS (Clipe Oficial) - YouTube
EXALTAI -   IGREJA BÍBLICA DA PAZ - YouTube
Ele Virá - Marcelo Markes (Clipe Oficial) - YouTube
Elizeu Alves - Sou Casa (Clipe Oficial) - YouTube
Em Teus Braços - Laura Souguellis // Fornalha Dunamis - Março 2015 - YouTube
Estamos de Pé (Ao Vivo) - Marcus Salles - YouTube
Eu Quero Um Avivamento - Paulo Junior - YouTube
Eu Também (100 Bilhões X) | Isaias Saad | So Will I | Lyric Vídeo - YouTube
Eu Tenho Um Chamado - Quatro por Um - YouTube
Eu te Amei Primeiro - Brás Adoração (Nicoleti) - YouTube
Expressão Vocal - Se Meu Povo Orar (Clipe Oficial) - YouTube
Fabiana Anastácio | Adorarei  (Vídeo Oficial) - YouTube
Fabiana Anastácio | Tua Presença | Cover - YouTube
Faz Arder + A Terra Clama - Julliany Souza Letra (Cover) - YouTube
Furioso Oceano - Jhonas Serra (CLIPE OFICIAL) - YouTube
Gabi Sampaio - Bom Perfume (Ao Vivo) - YouTube
Grace To Grace - Hillsong Worship (Português Oficial) by Caio feat. Sheylla, Diego & Silas - YouTube
Heloisa Rosa - Yeshua (Live Session) - YouTube
Heloísa Rosa - Há um lugar - Legendado.wmv - YouTube
Hugo Rosa - Perfeito Amor - YouTube
ISAIAS SAAD + NÍVEA SOARES - RUJA O LEÃO / QUE SE ABRAM OS CÉUS (AO VIVO) - YouTube
ISAIAS SAAD - BONDADE DE DEUS (AO VIVO) - YouTube
Igraja Batista Nova Jerusalém - Quão Formoso És - YouTube
Imafe Music - Tudo Novo De Novo - YouTube
Isadora Pompeo - Como Nunca Antes (Vertical Video) - YouTube
Isadora Pompeo - Para que Entre o Rei/Lindo És/Só quero ver você | Ao Vivo - YouTube
Israel Salazar - Tudo Que Me Prometeu (Ao Vivo Em Belo Horizonte / 2020) - YouTube
Jairo Bonfim - Vem Com Teu Fogo (Clipe Oficial MK Music em HD) - YouTube
Jotta A - Descansarei (CD ESSÊNCIA) - YouTube
Julia Vitoria - Não Mais Escravos (No Longer Slaves) - Live Session - YouTube
Kleber Lucas - Aos Pés Da Cruz (Clipe Oficial MK Music) - YouTube
Kleber Lucas - MEU ALVO - YouTube
LEANDRO SOARES - TODAVIA ME ALEGRAREI (CLIPE OFICIAL) - YouTube
LEVA-ME ALÉM - TOQUE NO ALTAR AO VIVO - YouTube
LUDI - Seu Amor ft. Isaías Saad (Clipe Oficial) - YouTube
Lauriete - Espírito de Deus ( Com Letra ) - YouTube
Livres Para Adorar-Te Exaltamos(feat..Daniela Ara - YouTube
MUSICA: CREIO (Anderson Bomfim) - YouTube
Mais que uma voz - Kléber Lucas - YouTube
Maravilhosa Graça   Alessandro Reis - YouTube
Marcelo Markes - Pai Nosso (Our Father) + Que Ele Cresça | Ao Vivo Na Lagoinha Conference 22 - YouTube
Marcos Góes -  Senhor, Formoso És - A Vigília 2 - YouTube
Maria Marçal | Deserto #MKnetwork - YouTube
Marine Friesen - Alfa e Ômega (AO VIVO) - YouTube
Marquinhos Gomes | Quarto Secreto (Clipe Oficial) - YouTube
Me Esvaziar - Nívea Soares - Legendado - YouTube
Me Lembrarei - Hillsong Em Português - YouTube
Michael Santiago - O Nome Jesus - YouTube
Ministério Apascentar de Nova Iguaçu - A vitória da Fé - YouTube
Ministério Nova Jerusalém - Tua Unção (Clipe Oficial MK Music) - YouTube
Ministério Zoe - Estrada da Fé (Video Oficial) - YouTube
Música: Nunca Me Deixou - Coral ABBA - Curitiba/PR - YouTube
Não Seremos Abalados OFICIAL | Nivea Soares | - YouTube
Oficina G3 - O Tempo (LETRA) | HD - YouTube
Os Cravos - Brás Adoração [Legendado] - YouTube
Ousado Amor (Clipe Oficial) - Isaias Saad - YouTube
Ousado Amor - Reckless Love | Nivea Soares - YouTube
PODE MORAR AQUI | THEO RUBIA (Vídeo Oficial) - Ao Vivo - YouTube
PODEROSO DEUS (com Letra) - Louvor e Adoração Pastor Antônio Cirilo - YouTube
POR TUDO QUE TU ÉS - RAQUEL EMERICK (CLIPE OFICIAL) - YouTube
Pai nosso (Our Father) + Grandioso és Tu • DROPS - YouTube
Poderoso Deus eterno | Juan Santos - YouTube
Porque Ele Vive // Victor Valente | Conferência Dunamis 2017 - YouTube
Pr. Lucas - O Lugar (Clipe Oficial MK Music) - YouTube
Prisma Brasil - Meu Lar - YouTube
Profético Soul - Jesus Chegou | Clipe Oficial - YouTube
PÃO DA VIDA - Cláudio Claro - DVD Magistral - YouTube
QUEM ELE É (Clipe Oficial) | Isaias Saad - YouTube
Quanto Amor - Groove Soul - YouTube
Quatro Por Um - Então É Só Clamar (Clipe Oficial MK Music) - YouTube
Quebrantado | Ministério Vineyard - YouTube
Quem Dizes Que Eu Sou - Nasci Pra Deus Music (Who you say I am - Hillsong Worship) - [Offical Video] - YouTube
REAL LOVE / AMOR REAL // Ministério Zion (Cover Lyrics) - YouTube
REPOUSA EM NÓS // Bárbara Tortelli // Rest On Us (Live Cover) - YouTube
Rei Salvador - Saviour King (tradução) - Hillsong - YouTube
Restauração - Nani Azevedo - Legendado - YouTube
Roberta Lima - Comprometido - YouTube
Ronaldo Bezerra - "Eu Te Louvarei Meu Bom Jesus" (Participação de PG) - YouTube
Samuel Messias - Os Planos de Deus (Clipe Oficial MK Music) - YouTube
Samuel Messias - Todavia me Alegrarei (Clipe Oficial MK Music) - YouTube
Santo  Tú es Santo   Nívea Soares - YouTube
Santo Espírito - Giselle Carmo & Brás Adoração - YouTube
Sarah Farias - Coisas Maiores (Clipe Oficial MK Music) - YouTube
Sarah Farias - Renovo (Clipe Oficial MK Music) - YouTube
Seguirei - Rose Nascimento - YouTube
Sempre Juntos - Banda Gerd - YouTube
Senhor Tu És Bom | Comunidade Zona Sul | Ao Vivo na CEIZS - YouTube
Soraya Moraes - Quão Grande é o Meu Deus (Sony Music Live) - YouTube
Sou um milagre - Voz da Verdade - YouTube
Só Quero Ver Você + There is Only One - Laura Souguellis & Rodolfo Abrantes // DVD FornalhaOficial - YouTube
Sync3 - Jó - ONErpm Gospel Showcase - YouTube
Sync3 | Pelejar por Jesus / Em Nome de Jesus - YouTube
Só Quero Queimar - Jhonas Serra - Lyric Vídeo - YouTube
Talita Costa - Quem dizes que eu sou (Who you say I am - Hillsong Worship) - [Official Video] - YouTube
Te louvarei- Frutos do Espírito - YouTube
Teu Amor Venceu (Ao Vivo) | SALVAON - YouTube
Teus Olhos - Marcos Witt - YouTube
Thalles Roberto - DVD - Arde outra Vez - Vídeo Oficial HD - YouTube
Toma o Teu Lugar - Daniel Souza - YouTube
Trio Nascimento - Chegou o Avivamento (Clipe Oficial MK Music em HD) - YouTube
Tua Presença - Gabi Oliveira feat Paulo Neto - YouTube
Tua unção - Além do véu - YouTube
Turbo Ensaio - Assenta te no Trono - Coral Resgate - YouTube
VEM ME BUSCAR l LOUVOR EVO | EVO CHURCH - YouTube
Vai Dar Tudo Certo - Gerson Rufino - Legendada - YouTube
Vai Passar - Samuel Mariano - DVD Antes, Durante e Depois do Culto - Ao Vivo - YouTube
Vanilda Bordieri - Viverei Milagres (Lyric Video) - YouTube
Verdadeiro Adorador - Alda Célia - YouTube
Volto Os Meus Olhos/ Vem Derrama - Dunamis Letra - YouTube
Vou Vencer Esse Gigante Samuel Messias feat. Wilian Nascimento ao vivo[sem som] - YouTube
Voz da Verdade - "Além do Rio Azul" - YouTube
Way Maker / Caminho no deserto - Mateus Brito/ Igreja Burn (Sinach/cover) - YouTube
além do rio azul voz da verdade  cantado e legendado - YouTube
fhop music, Marco Telles | ÚNICO (Letra) - YouTube
És real pra mim | Afonso Ribeiro - YouTube